#S############### 
#               # 
# ### ####### # # 
# #         #   # 
# # # # # ### # # 
# # # # #     # # 
# ### # # ##### # 
#   # # #     # # 
# # # # # # # # # 
# # # # # # #   # 
# ### # # ### ### 
#   # # #   #   # 
# # # # # # # # # 
# # # # # # # # # 
# ##### # ### # # 
#   #   #     # # 
###############G# 
                  
